# Datatypes (KEYWORD1)

PX	KEYWORD1

# Methods and Functions (KEYWORD2)

get	KEYWORD2
init	KEYWORD2
isr	KEYWORD2
get	KEYWORD2
decode	KEYWORD2
decode	KEYWORD2
channel KEYWORD2
data  	KEYWORD2
err  	KEYWORD2



# Constants (LITERAL1)

SX1	LITERAL1
SX2	LITERAL1
MAX_CHANNEL_NUMBER	LITERAL1
SCOPE	LITERAL1
SYNC	LITERAL1
ADDR	LITERAL1
DATA	LITERAL1
MAX_DATACOUNT	LITERAL1
MAX_DATABITCOUNT	LITERAL1
MAX_CHANNEL_NUMBER	LITERAL1
COMMAND_OK       LITERAL1
COMMAND_ERROR    LITERAL1
